1111111111111111
1000000P00000001
1000000000000E11
1C00000000001CC1
1111111111111111
