111111111111111111111111111
1E00000000000000C0000000001
101001010010000010100110101
101001001010101000100110101
1P0000000C00C00000000000001
111111111111111111111111111
