111111111111111111111111111
1E10000000000000C0000000001
101001010010000010100110101
101001001010101000100110101
10000000C00C0000000000000P1
111111111111111111111111111
