1111111111111111111111111111111111
10000000000000E0100000100000000001
1010010100100000101001000000010101
1010010010101010001001000000010101
1P00000001001000000000001110000001
1111111111111111111111111111111111
