1111111111111111111111111111111111
1E00000000000000C00000C00000000001
1010010100100000101001000000010101
1010010010101010001001000000010101
100000000C00C000000000001C10000001
1111111111111111111111111111111111
